NO ./textures/north.xpm
SO  ./textures/south.xpm
WE ./textures/west.xpm
EA ./textures/east.xpm

F 220,100,0
C 225,30,0


111111111111111111
1000 0000000000001
111111110111111101
       101     1N1
11111111011111110111
1AbcdFHkLRw000000001
11111111111111111111