NO ./textures/3d/north.xpm
SO  ./textures/3d/south.xpm
WE ./textures/3d/west.xpm
EA ./textures/3d/east.xpm

F 220,100,0
C 225,30,0



11111111111111111111
eAbcdFHkLRw000000001
10001000000000000001
10000000000000000001
10000000000000000001
10000000000000000001
100000000000N00000001
10000000000000000001
10000000000000000001
10000000000000000001
11111111111111111111
