NO ./textures/north.xpm
SO  ./textures/south.xpm
WE ./textures/west.xpm
EA ./textures/east.xpm

F 220,100,0
C 225,30,0


111111111111111111
100000000000000001
111111110111111101
       101     1N1
1111111101111111d111
eAbcdFHkLRw000000001
10001000000000000001
10000000000000000001
10000000000000000001
10000000000000000001
10000000000000000001
10000000000000000001
10000000000000000001
10000000000000000001
11111111111111111111
1111111111111111111